1111111111111111111111111
1111111111111111111111111
...................1.....
...................11....
................111...111
11111111111111111...11111
111111111111111.1.1111111
...11....................
111111...................
1111111111.11111111111111
1111111111...111111111111
..........XXXXXX.........
..XXXXXXX.........p......

